1111311111211311112111311111211111112211131
1000000000000000000000000000000000000000001
2000005000000000000000000000000000000004003
1000000000000000000000000000000000000000001
2000000000000000000000004000000000000000002
1000000000000000000000000000000000000000001
2000000000050000000000000000005000000000001
3000000000000000000000000000000000000000001
1000000000000000000000000000000000000000002
1000000000000000000050000000000000000000001
2000000000000000004504550000000000000000002
1000000000000000004000040500000000000000001
3000000000000000050055040000000000050000001
1000000000000040000400400000000000000000001
1000000000000000000000000000000000000000003
2000000000000000000000000000000000000000001
1000000000000000000000040000000000000000002
1000000000000000000000000000000000000000001
3000000000000000000000000000000000000000001
1000000000000000000000000000000000000000001
1000000000000000000000000000000000000000003
1000000000000000005000000000000000040000001
2005000000000000000000000000000000000000003
3000000000000000000000000000000000000000001
1121111111311112113111121311121111211311111