1111111111111111111111111111111111111111111
1000000000000000000000000000000000000000001
1000002000000000000000000000000000000002001
1000000000000000000000000000000000000000001
1000000000000000000000002000000000000000001
1000000000000000000000000000000000000000001
1000000000020000000000000000002000000000001
1000000000000000000000000000000000000000001
1000000000000000000000000000000000000000001
1000000000000000000020000000000000000000001
1000000000000000002202220000000000000000001
1000000000000000002000020200000000000000001
1000000000000000020022020000000000020000001
1000000000000020000200200000000000000000001
1000000000000000000000000000000000000000001
1000000000000000000000000000000000000000001
1000000000000000000000020000000000000000001
1000000000000000000000000000000000000000001
1000000000000000000000000000000000000000001
1000000000000000000000000000000000000000001
1000000000000000000000000000000000000000001
1000000000000000002000000000000000020000001
1002000000000000000000000000000000000000001
1000000000000000000000000000000000000000001
1111111111111111111111111111111111111111111